11111111111
10021212121
10121212121
12222222221
12121212101
12121212001
11111111111