11111111111
10022222221
10222222221
12222222221
12222222201
12222222001
11111111111