11111111111
10010000001
10101010101
10000000001
10101010101
10000001001
11111111111